{
  "df_target_to_id": {
    "%F1982": 0,
    "%F1926": 1,
    "%F2002": 2,
    "%F2003": 3,
    "%F2006": 4,
    "%F2213": 5,
    "%F2057": 6,
    "%F2048": 7
  }
}